Локації / Місця

+ Georgefarm - ферма Джорджа (погано: Джорджфарм, Джорджфам, Георгової ферми)
+ Headless Ripper Inn - таверна "Безголовий рипер" (погано: заїзд, Безголовий розбійник, корчма Безголовий Рипер, Різник)
+ Lost Quarter  - Забутий квартал (погано: загублений, заблудший)
+ Red Tower - Червона вежа (погано: башта)
+ Refuge - Притулок (погано: Убежище)
+ Remnants / Remnants' camp - Вцілілі / табір Вцілілих (погано: Залишки, Рештки, Відходи, Ремнати, Останки, Спадкоємці)
+ Ruin Raiders' - Рейдери Руїн (погано: Руїнні Рейдери, Завойовники, Руйнівники, Руйнаторів)
+ Nemeton - Неметон (погано: Нементон, Нематон, Нметон)
+ Woodcutter Camp - табір Лісорубів (погано: Лісопильний Табір, Лісорубний табір)
+ Coniferous Forest - Хвойний ліс
+ Floodplain Forest - Заплавний ліс
+ Forest Primeval - Праліс
+ Sacred Grove - Священний Гай
+ Red Moor - Червоне багновище
+ Morbid Moor - Зловісне багновище
+ Knawd Moor  - Криваве багновище 
+ Heiress of the Moor - ? Спадкоємиця Багновища
+ Heath - Пустище (погано: Торфовище)

- Riverbed - 
- The Pit - Яма чи Шахта?
- Deep Mine


Поняття  / Назви предметів

+ fossil - скам'янілість
+ Hewers - Каменярі (Погано: Гірники, Рубщики, Рубаки, розпилювачі, Ковальські, трударів; Вибійники (Забійники); Рудокопи;)
+ Rustmoss - іржавий мох
+ Rustroot - іржавий корінь
+ Bygones - Древні (Погано: Стародавній-Бійгонсів-Залишені-Багатовікові)
+ Divinity - Божество
+ Sovereign - Правитель
+ Mighty Boar - Могутній Кабан (Погано: Великий Кабан, Вепр)
+ Rune vessels - Рунічні посудини (Погано: Рунні судини, сосуди, весселі)
+ Marked Ones - Помічені, Позначені
+ Silver Smasher - Руйнівник Срібла (погано: «Срібний Крушитель», Срібний Ударник, Срібний молот )
+ callashrooms - Червоний гриб (калашруми)

- Land of legend - Країна легенд, Земля легенд
- Bonded - ? Пов'язані (Зв'язані)
- Blackflame - ? Чорне Полум'я, Чорний Пламінь
- Gorge - Прірва
- ripper - риппери, рипери, різники
- snaptors - снаптори, снатори
- digpig - кабан рикун копач свиня










